14,14,14,14,14,14,14,14,14,14,14,14,14,14,14,14,14,14,14,8,13,13,13,13,13,13,13,13,13,13,13,13,13,13,11,14,14,14,14,14,14,14,14,14,14,14,14,14,14,14,14,14,14,8,13,13,13,13,13,13,13,13,13,13,11,14,14,14,14,14,14,14,14,14,14,14,14,14,14,14,14,14,14,14,14,14,14,14,14,14,14,14,14,14,14,14,14,14,14,14,14,14,14,14,14,14,14,14,14,14,14,14,14,14,14,14,14,14,14,14,14,14,14,14,14,14,14,14,14,14,14,14,14,14,14,14,14,14,14,14,14,14,14,14,14,5,6,14,14,14,14,14,14,14,14,14,14,14,14,14,14,14,14,5,6,14,14,5,6,14,14,14,14,14,14,14,14,14,14,14,14,14,14,14,14,14,14,14,14,14,4,4
14,14,14,14,14,14,14,14,14,14,14,14,14,14,14,14,14,14,14,14,12,13,13,13,13,13,13,13,13,13,13,13,13,7,14,14,14,14,14,14,14,14,14,14,14,14,14,14,14,14,14,14,14,14,12,13,13,13,13,13,13,13,13,7,14,14,14,14,14,14,14,14,14,14,14,14,14,14,14,14,14,14,14,14,14,14,14,14,14,14,14,14,14,14,14,14,14,14,14,14,14,14,14,14,14,14,14,14,14,14,14,14,14,14,14,14,14,14,14,14,14,14,14,14,14,14,14,14,14,14,14,14,14,14,14,14,14,14,14,14,14,14,14,14,14,5,6,14,14,14,14,14,14,14,14,14,14,14,14,14,14,14,14,5,6,14,14,5,6,14,14,14,14,14,14,14,14,14,14,14,14,14,14,14,14,14,14,14,14,14,4,4
14,14,14,14,14,14,14,14,14,14,14,14,14,14,14,14,14,14,14,14,14,8,9,10,7,8,9,10,11,12,9,10,11,14,14,14,14,14,14,14,14,14,14,14,14,14,14,14,14,14,14,14,14,14,14,8,7,8,9,10,11,12,11,14,14,14,14,14,14,14,14,14,14,14,14,14,14,14,14,14,14,14,14,14,14,14,14,14,14,14,14,14,14,14,14,14,14,14,14,14,14,14,14,14,14,14,14,14,14,14,14,14,14,14,14,14,14,14,14,14,14,14,14,14,14,14,14,14,14,14,14,14,14,14,14,14,14,14,14,14,14,14,14,14,14,5,6,14,14,14,14,14,14,14,14,14,14,14,14,14,14,14,14,5,6,14,14,5,6,14,14,14,14,14,14,14,14,14,14,14,14,14,14,14,14,14,14,14,14,14,4,4
14,14,14,14,14,14,14,14,14,14,14,14,14,14,14,14,14,14,14,14,14,14,5,6,14,14,5,6,14,14,5,6,14,14,14,14,14,14,14,14,14,14,14,14,14,14,14,14,14,14,14,14,14,14,14,14,14,14,5,6,14,14,14,14,14,14,14,14,14,14,14,14,14,14,14,14,14,14,14,14,14,14,14,14,14,14,14,14,14,14,14,14,14,14,14,14,14,14,14,14,14,14,14,14,14,14,14,14,14,14,14,14,14,14,14,14,14,14,14,14,14,14,14,14,14,14,14,14,14,14,14,14,14,14,14,14,14,14,14,14,14,14,14,14,14,5,6,14,14,14,14,14,14,14,14,14,14,14,14,14,14,14,14,5,6,14,14,5,6,14,14,14,14,14,14,14,14,14,14,14,14,14,14,14,14,14,14,14,14,14,4,4
14,14,14,14,14,14,14,14,14,14,14,14,14,14,14,14,14,14,14,14,14,14,5,6,14,14,5,6,14,14,5,6,14,14,14,14,14,14,14,14,14,14,14,14,14,14,14,14,14,14,14,14,14,14,14,14,14,14,5,6,14,14,14,14,14,14,14,14,14,14,14,14,14,14,14,14,14,14,14,14,14,14,14,14,14,4,4,4,4,4,4,4,4,4,4,14,14,14,14,14,14,14,14,14,14,14,14,14,14,14,14,14,14,14,14,14,14,14,14,14,14,14,14,14,14,14,14,14,14,14,14,14,14,14,14,14,14,14,14,14,14,14,14,14,14,5,6,14,14,14,14,14,14,14,14,14,14,14,14,14,14,14,14,5,6,14,14,5,6,14,14,14,14,14,14,14,14,14,14,14,14,14,14,14,14,14,14,14,14,14,4,4
14,14,14,14,14,14,14,14,14,14,14,14,14,14,14,14,14,14,14,14,14,14,5,6,14,14,5,6,14,14,5,6,14,14,14,14,14,14,14,14,14,14,14,14,14,14,14,14,14,14,14,14,14,14,14,14,14,14,5,6,14,14,14,14,14,14,14,14,14,14,14,14,14,14,14,14,14,14,14,14,14,14,14,14,14,4,14,14,14,14,14,14,14,14,4,14,14,14,14,14,14,14,14,14,14,14,14,14,14,14,14,14,14,14,14,14,14,14,14,14,14,14,14,14,14,14,14,14,14,14,14,14,14,14,14,14,14,14,14,14,14,14,14,14,14,5,6,14,14,14,14,14,14,14,14,14,14,14,14,14,14,14,14,5,6,14,14,5,6,14,14,14,14,14,14,14,14,14,14,14,14,14,14,14,14,14,14,14,14,14,4,4
14,14,14,14,14,14,14,14,14,14,14,14,14,14,14,14,14,14,14,14,14,14,5,6,14,14,5,6,14,14,5,6,14,14,14,14,14,14,14,14,14,14,14,14,14,14,14,14,14,14,14,14,14,14,14,14,14,14,5,6,14,14,14,14,14,14,14,14,14,14,14,14,14,14,14,14,14,14,14,14,14,14,14,4,4,4,14,14,14,14,14,14,14,14,4,4,4,14,14,14,14,14,14,14,14,14,14,14,14,14,14,14,14,14,14,14,14,14,14,14,14,14,14,14,14,14,4,14,14,14,4,14,14,14,4,14,14,14,14,14,14,14,14,14,14,5,6,14,14,14,14,14,14,14,14,14,14,14,14,14,14,14,14,5,6,14,14,5,6,14,14,14,14,14,14,14,14,14,14,14,14,14,14,14,14,14,14,14,14,14,4,4
14,14,14,14,14,14,14,14,14,14,14,14,14,14,14,14,14,14,14,14,14,14,5,6,14,14,5,6,14,14,5,6,14,14,14,14,14,14,14,14,14,14,14,14,14,14,14,14,14,14,14,14,14,14,14,14,14,14,5,6,14,14,14,14,14,14,14,14,14,14,14,14,14,14,14,14,14,14,14,14,14,14,14,4,14,14,14,14,14,14,14,14,14,14,14,14,4,14,14,14,14,14,14,14,14,14,14,14,14,14,14,14,14,14,14,14,14,14,14,14,14,14,14,14,14,14,14,14,14,14,14,14,14,14,4,14,14,14,14,14,14,14,14,14,14,5,6,14,14,14,14,14,14,14,14,14,14,14,14,14,14,14,14,5,6,14,14,5,6,14,14,14,14,14,14,14,14,14,14,14,14,14,14,14,14,14,14,14,14,14,4,4
14,14,14,14,14,14,14,14,14,14,14,14,14,14,14,14,14,14,14,14,14,14,5,6,14,14,5,6,14,14,5,6,14,14,14,14,14,14,14,14,14,14,14,14,14,4,4,14,14,14,14,14,14,14,14,14,14,14,5,6,14,14,14,14,14,14,14,14,14,14,14,14,14,14,14,14,14,14,14,14,14,4,4,4,14,14,14,14,14,14,14,14,14,14,14,14,4,4,4,14,14,14,14,14,14,14,14,14,14,14,14,14,14,14,14,14,14,14,14,14,14,14,4,14,14,14,14,14,14,14,14,14,14,14,4,14,14,14,14,14,14,14,14,14,14,5,6,14,14,14,14,14,14,14,14,14,14,14,14,14,14,14,14,5,6,14,14,5,6,14,14,14,14,14,14,14,14,14,14,14,14,14,14,14,14,4,4,4,14,14,4,4
14,14,14,14,14,14,14,14,14,14,14,4,4,14,14,14,14,14,14,14,14,14,5,6,14,14,5,6,14,14,5,6,14,14,14,14,14,14,14,14,14,14,14,14,14,4,4,14,14,14,14,14,14,14,14,14,14,14,5,6,14,14,14,14,14,14,14,14,14,14,14,14,14,14,14,14,4,4,14,14,14,14,14,14,14,14,14,14,14,14,14,14,14,14,14,14,14,14,14,14,14,14,4,4,14,14,14,14,14,14,14,14,14,14,14,14,14,14,14,14,14,14,14,14,14,14,14,14,14,14,14,14,14,14,4,14,14,14,14,14,14,14,14,14,14,5,6,14,14,14,14,14,14,14,14,14,14,14,14,14,14,14,14,5,6,14,14,5,6,14,14,14,14,14,14,14,14,14,14,14,14,14,4,4,4,4,4,4,4,4,4,4
14,14,14,14,14,14,14,14,14,14,14,4,4,14,14,14,14,14,14,14,14,14,5,6,14,14,5,6,14,14,5,6,14,14,14,14,14,14,14,14,14,14,14,14,14,4,4,14,14,14,14,14,14,14,14,14,14,14,5,6,14,14,14,14,14,14,14,14,14,14,14,14,14,14,14,14,4,4,14,14,14,14,14,14,14,14,14,14,14,14,14,14,14,14,14,14,14,14,14,14,14,14,4,4,14,14,14,14,14,14,14,14,14,14,14,14,14,14,4,14,14,14,14,14,14,14,14,14,14,14,14,14,14,14,4,14,14,14,14,14,14,14,14,14,14,5,6,14,14,14,14,14,14,14,14,14,14,14,14,14,14,14,14,5,6,14,14,5,6,14,14,14,14,14,14,14,14,14,4,4,4,4,4,4,4,4,4,4,4,4,4,4
0,0,0,0,0,0,0,0,0,0,0,0,0,0,0,0,0,0,0,0,0,0,0,0,0,0,0,0,0,0,0,0,0,0,0,0,0,0,0,0,0,0,0,0,0,0,0,0,0,0,0,0,0,0,0,0,0,0,0,0,0,0,0,14,14,14,0,0,0,0,0,0,0,0,0,0,0,0,0,0,0,0,0,0,0,0,0,0,0,0,0,0,0,0,0,0,0,0,0,0,0,0,0,0,0,0,0,0,0,0,0,0,0,0,0,0,0,0,0,0,0,0,0,0,0,0,0,0,0,0,0,0,14,14,0,0,0,0,0,0,0,0,0,0,0,0,0,0,0,0,0,0,0,0,0,0,0,0,0,0,0,0,0,0,0,0,0,0,0,0,0,0,0,0,0,0,0,0,0,0,0,0,0,0,0,0,0,0,0,0,0,0
1,1,1,1,1,1,1,1,1,1,1,1,1,1,1,1,1,1,1,1,1,1,1,1,1,1,1,1,1,1,1,1,1,1,1,1,1,1,1,1,1,1,1,1,1,1,1,1,1,1,1,1,1,1,1,1,1,1,1,1,1,1,1,14,14,14,1,1,1,1,1,1,1,1,1,1,1,1,1,1,1,1,1,1,1,1,1,1,1,1,1,1,1,1,1,1,1,1,1,1,1,1,1,1,1,1,1,1,1,1,1,1,1,1,1,1,1,1,1,1,1,1,1,1,1,1,1,1,1,1,1,1,14,14,1,1,1,1,1,1,1,1,1,1,1,1,1,1,1,1,1,1,1,1,1,1,1,1,1,1,1,1,1,1,1,1,1,1,1,1,1,1,1,1,1,1,1,1,1,1,1,1,1,1,1,1,1,1,1,1,1,1
1,1,1,1,1,1,1,1,1,1,1,1,1,1,1,1,1,1,1,1,1,1,1,1,1,1,1,1,1,1,1,1,1,1,1,1,1,1,1,1,1,1,1,1,1,1,1,1,1,1,1,1,1,1,1,1,1,1,1,1,1,1,1,14,14,14,1,1,1,1,1,1,1,1,1,1,1,1,1,1,1,1,1,1,1,1,1,1,1,1,1,1,1,1,1,1,1,1,1,1,1,1,1,1,1,1,1,1,1,1,1,1,1,1,1,1,1,1,1,1,1,1,1,1,1,1,1,1,1,1,1,1,14,14,1,1,1,1,1,1,1,1,1,1,1,1,1,1,1,1,1,1,1,1,1,1,1,1,1,1,1,1,1,1,1,1,1,1,1,1,1,1,1,1,1,1,1,1,1,1,1,1,1,1,1,1,1,1,1,1,1,1
